2147483648S,0C
0 0
1481 1
1491 1
1489 1
1029 1
14619 1
1025 1
1034 1
7183 1
1050 1
1024 1
1027 1
4095 1
1024 1
1030 1
1041 1
1037 1
1029 1
7180 1
-7180 -1
7180 1
8783 1
24827 1
9500 1
1030 1
1029 1
1028 1
1030 1
1028 1
1036 1
1054 1
1478 1
1039 1
6845 1
7283 1
6831 1
6831 1
6829 1
1037 1
1477 1
1049 1
5266 1
-5266 -1
